10x10
- . . . . - - - - -
. . . . . . . . . -
. . . . . - - - - -
. . . . . . . . . -
. . . . . . . . . -
. . . . . . . . . -
. . . . . . . . . -
. . . . . . . . . -
. . . . . . . . . -
. . . . . . . . . -
